111111111111111111111111111111111111111111111111111111111
1P0000000000000000000C00000000000000000000010000000000001
100000000000000000000000000000000000000000010000000000001
100000000000000000000000000000000000000000010000000000001
10000000000000000000000000000000C000000000010000000000001
100000000000000000000000000000000000000000000000000000001
100000000000000000000001111111111111111111111111111110001
100000000000000000000001000000010000000000000000000000001
10C000000000000000000001000E0001C000000000000000000000001
100000000000000000000001000000010000000000000000000000001
1000000000000000000000C1111011110000000000000000000000001
100000000000000000000000000000010000000000000000000000001
100000000000000000000000000000010000000000001111111111111
1000000000000000000000000000000100000000000010000000000C1
100000000000000000000000000000010000000000001000000000001
100000000000000000000000000000010000000000001000000000001
1000000000000000000000000000C0010000000000000000000000001
111111111111111111111111111111111111111111111111111111111