1111111111111111111111111111111111
1E00000000V0000C00000C0000V0000001
1010010100100000101001000000V10101
1010010010101010001001000000010101
1P0000000C00C000V000000000000000C1
1111111111111111111111111111111111
