1111111111111111111111111111111111
1E0000010000000C0000VC000000000001
1010010010101010001001000000010101
10100101001000001010010000V0010101
1010010010101010001001000000010101
1010010010101010001001000000010101
1P0000000C00C0000000000000000001C1
1111111111111111111111111111111111